07,05,05,05,05,05,05,05,05,06
01,08,08,08,08,08,08,08,08,04
01,08,09,09,09,09,09,09,08,04
01,08,09,10,10,10,10,09,08,04
01,08,09,10,11,11,10,09,08,04
01,08,09,10,11,11,10,09,08,04
01,08,09,10,10,10,10,09,08,04
01,08,09,09,09,09,09,09,08,04
01,08,08,08,08,08,08,08,08,04
00,02,02,02,02,02,02,02,02,03

1,1,1,1,1,1,1,1,1,1
1,0,0,0,0,0,0,0,0,1
1,0,0,0,0,0,0,0,0,1
1,0,0,0,0,0,0,0,0,1
1,0,0,0,0,0,0,0,0,1
1,0,0,0,0,0,0,0,0,1
1,0,0,0,0,0,0,0,0,1
1,0,0,0,0,0,0,0,0,1
1,0,0,0,0,0,0,0,0,1
1,1,1,1,1,1,1,1,1,1